rjq: mkj bbr xrh mnn
zch: zvf pnk bbk njb
jms: vhm gdp jxq tmj
qkz: qpl rlb rfv
lnl: knh nls
hlb: tfj qpl mvk bkq
tnh: gvl
fdq: xrc shj
qpm: rsr
vqs: tbh stv
szl: qlx pll
ptp: dpq tln mmm
nvf: xtg qmj tvr hkd cdv
lfd: pbv rbs nvb
ltj: szt ckq klt ffn
bzl: ptt nvr
bfj: mzh
nvx: tnk cnl bps
sqr: hqn zbl bzl rbf
cnl: mgp
grm: dts bnb kht jdd
sjv: rbf
rvn: lcn rfc
hxb: snf plx
jjr: jln lqz ppl sss
mkz: bvx ccc
bqq: dkq cjn gzt pgv
bnm: jxq skm bbb
vxc: jfc zqn rcz pzt
drc: zdh dts fxj fxr cqz sft lxn szb dtd
klk: lpl glz
skk: rnc vgf
bfh: vlz knk zmp fvl jtn cts
fjd: fzv hgx rtz
vmk: jlg bgk zbq
qbj: czz
dmh: mfn lvn
lpj: zbx sbp
czf: jqr dbg nbg
cfc: zbx lpj ftd
tdp: zgk knt spm
ffh: qhx rbs
ztk: drm kpr
fvh: nhb vdh
kdp: nhs lnm sfd kkk
sfq: zps plq hhz
lms: cvt rqh
qzf: mrp jht hjc
prc: cpb bcp
qqk: dts gdx qpg bsk
gfg: ckk hhp
skm: vnr qpg
nhr: glx ptm
fhp: lrb bvf
tfk: mnh xms zps qhh
mnh: lcs
khq: szs qdj
sgf: dng
gsl: rzn bkr qhf
hcf: nvb
rzz: vgt rfv vvl
qsd: dxd kqq nch
bqr: mpc
kdx: gpc bhc pbv bnt zpq qkz
bjg: sjv dtn vnr kjg
nfv: jjl kpd xlj csb
dfh: ggt
shq: clg pkr bxg
zdc: cll fgz vmq bjl
nzj: nqp cvb crs vrt mjc
qbt: flj fzg xkb
nnb: xgn
ddl: czx zpx
njb: kcv smm hck
sgd: llv qrt lkj xgt
nzm: rfm xgt pcp
kth: zqj prp cpl tqv
vfc: rrk fsd bmb
rxb: kkm
ftm: lfd rpk prj glh
qjs: njc khq ftf ckr
vjq: cvk
hqq: krf jng frb qmf
mbs: glq
spl: cxh fvh
cxb: jln xds rns qdd plr
cph: hcf
kdc: tdr mfh nrr
fsd: lvm gdg
nvj: lhz qsd hcz tnz
sfz: kzl xgb bbk vjq tfj tsv
fkt: lgp xcd pjs
nkr: zpx lnm
drh: dtn
zzd: lbc skv xzd lgh gtf zgk
rvv: vhl ljb
mtl: jdt znn qcg lzm
cth: dkq xxk dfs
qhd: fgx hpn
gdm: jjm ljz
zqp: xgn vrt pxn
ktz: shj fxr
kcq: pbk ffj jbf ctm
cxj: pjt ksh ckx
crp: vnc
hzz: fll hcf fds qbs
tnk: rxk
pcc: nmq kzp lfs lfj mfh
bjt: nbb fbl
zcj: mzh pkk lnl ffh
bnr: cfc glx hbt
zgk: ckk cbz
xlc: cjn jkz kxs
mxp: qmj kgc
hvl: vgt
nqp: lvm hqx
hqr: ktb
jtr: ktx xbm
rsg: bnh tnh hnd
hsj: fpf fkt cjr ghj ktj
frt: hxm jtj
clr: ctx ssr sjd bnx jcc
slf: llg bzn bxs fdm kfk
ptr: ljp qhg cjn cth fdm
rpr: czz rfc
hzc: rcz
qhx: zcn czz
sxf: ctm
fmj: xvc
gnq: vcc cps nzk ftx
gzt: mcb bdr
qnf: pqv rqd
gbk: zgj
jbx: scs jph mgf xkl
kkk: ctx sjq
rkv: fdr
zqt: rvh
qgr: xzx nzm fxn
frs: khq ptj jrv flx
klt: nkb bmg
vjt: vfc rtv
tqq: vdj
mgb: qqj
jnn: kcr sfn cgc lvz
ngl: hhl
jdd: mrk
qvd: skk sdj xrs zdr
jng: rpf vgt
qkn: gjt hvc
gnh: djj mnc bgg
ftf: klk prc qdb
zrj: znn zmp
jsl: jcc nsf nsx jnm
fbh: ksl rqm mjx nsn
ctv: cfj tml brv nbr cts
rqh: txz dkv tpj
kht: gsz jxg rsf
xdt: nhk
mpv: mdg znn rkv
gdj: kxs
pmm: vqd zxd fdq mxp
zlq: svt vjb mlp csm
mql: htv ggm
jph: rqz rll
kch: kmx drm jtj lvn
rsf: rdd
thk: rxx hvg fcs
vnz: hmm pgv
ftd: bzz
pfb: xbm jlz trh
sfr: khg qhf
cks: lkj tvb trv
kng: qsm hxb ctk vfb bcd tvf
bzt: drj hls gvx
sjd: tcx
rzn: mcr vhm
vcp: kmx vhk nvp lvn ltl
lfl: mrk mlh fsd vqm
lfb: tfp hxm tpr gdp
hqx: sjf
nzk: nbr vhl
nxq: nbb
vrn: hvx mbs
pbq: vlj qqj
szs: pgv vgv cgq
drg: sxq zrj bxs
spr: vcb ztk
lnk: nkz
vfh: bvm clc nfj lms
lkf: tkb
tqp: vqd knh pbp lbc
snn: gfx rkd vxq
sfn: zxx
mfj: vpc qlk mcm
hnd: pxb rfm lng sbz
ghn: scf
vnx: vpc zmk
tsp: pvg scf ztj csb
fxz: tqq jdt
kcs: bdr
prm: mcb zgb dpn fmk zxt
vqt: bvm bnf fdq vqd
hvz: mqf qcl
gpl: plq jnk gmv bgg
fdp: txz cft kht
vrv: cvx rsg sjg
bnx: qzf dbh
bns: zxr sfp kkm jms
hkq: spl mrq mxc tqt
xss: zsd pvg hzt xcd
sbs: jln fcn cft
gkx: lrd
nhl: fml
cvc: lxj
bzp: knk fzg tvf
rsr: fzr spr
ccb: lzr nsn
xrc: zxr pmk
fpf: qlv glz vkr
nrg: cnb ghk glz rnp rnt
szx: rxk jgl fvh
jgq: drx rll zsd
vll: shv ggm pvn lnx
kdq: rkq drh zrp xrh mmh
ztq: ccc jkr
gcg: fqq bqm nfz mdk
nzd: hft gxl hjc
lvk: hqh mss
htk: zjk qzx vqd fxj
lnn: rxf bsp zvp
pmk: mgt bbm
fxf: tnf fhp vts gqb
vhl: ztz dlp pgt
jgn: lzt ckk zjg
pkg: ztk ttf hpz ffl
pqs: mvf rdt dmt gbg
rqm: cpx
lrd: pcp lbc nbb qft
vkr: lrt pzb
mrb: gvl sjf gvc
jtt: tzh jht jtn gxl
vvs: xkv vgf pzt
xvf: svn rkq bsk rpr
nff: cpb hqh
cxc: mqv kxc drk cpx szq
zgb: lcv
smk: zxx hql
krs: hhc dzk hhf cvt
jxf: mrq xlc lnx lzk
dnp: hfl dkq rll znn
dnl: hbc
xlb: fdz
jgz: mcm
vrc: tmj dtd txz trj
ccc: jnk
xmm: bqr dzp
kfr: bfj cxk vts
ltv: sgf
psj: bqr zdj
jcb: rpx
xxk: kcr
rgj: clg knn
rtk: qdr ckq plr rxx
ldr: ghl ldq ktx
jjl: cjn ztz vjb
xkq: pqv lfz nqf jnt
dhq: bfz vjq sfr
jbf: svp
cxn: cbv fvt krf
tqn: vhd jbh mbp tfj vrn
cnb: zng xvc jkm sjb
tkr: bcv
xbm: hvc
dsg: hqx pxb frt vlr
ctd: bzz
mpr: djj hvc
jjz: jqs
tgb: rtv dzt gvc kvn blj
tvj: bnb drh mgt mlh
blc: qkv zjg nvr xxx
prj: ffl lvl txv
hnf: mnh fdm xsj
pzg: drm
dtd: gxk hcd
rqr: lkl mms btp
ssv: fcs rfm
frb: lpk nkf llr
kkr: mzr fbl hzf nfq
vsb: fxr ksk txs nkk
vzt: ncv tql mhk ldq pgt svt
smm: ngg zxr
bdr: zgj
ddg: hgx lpl
fvj: zjk fqk xjr rzn
jsx: nrj zqt qlx gsf
pnb: jkz rhb vlb vpz
gtt: plv
dzt: dss
jvh: nvp fcs dns
jht: mvz bsp
fsz: vks lcz jbs zjk
src: gsz
tfq: pll
xjk: cvk
nsf: jtr vmq sbp
lbj: tgc
kkd: bxg
tks: vgf
qlk: plx brv
cgc: htl rcz
zbq: xch fzv sjd
kcv: rcg
kbh: qnp vjg mzg srl
bff: rgp gvl qzd hrh
bhg: nbb
xdv: sfd rrv cnl rhb hfl
xtp: csn hft lcv
pcz: mpj tcd
cpl: nps zmn
jhg: vdj
qmj: gkq nls
dss: dmv
pff: fjr qcl tdx kxz
fvl: sfd ffr vxr
hcz: fvp cdt zcc ffn qmb
ktj: njc dbb jgz djj snf
fxj: rsg zlv
sgx: kvh fcn
rnq: mph hzc
bhn: qsk bgk nrk ltm
ttl: lcs qbt bcp xvs
hsm: xlb rpf ztt gtt kdq
fsb: fvb ghf rsf pbp mpj nls
xhg: qrc rxk jhj
kxq: clz rxf
rmc: qnh hsn xch bgg
dts: qmz qpm
fsg: cll
kxb: zbz
kct: hhd jmg zrj shl
tnz: ksg lrb rml
mnn: bbm cvk
shf: mqf hvb cxn
fdr: jnk nrj fvn
gdp: cks vpf
cvb: ghf gdn hjd
spm: bvt
stz: jjz
sbp: plx
zdf: vnc tpj
ljz: jlx
lmz: vhh tqt scf crf
csq: sgd crp mbs
vhc: dtr ggx
zdj: nvt ffr sxq ftx lvk
ghl: lsd
zzb: flj jgq prf
llq: kxc jlx jch
fdc: fmj sjn ptl hdq
ssr: hgx btp qhg
fqq: tnz pds hvr
zpq: jgm nfj fzr
pzv: kfp smx mcb
xlt: zcv zcj dxd dss
mrq: bps qhg qgs
ckr: rll
xcd: ptj
bfx: smh fqz zdp
lsd: ctd
nbc: gdg spm
qlp: vlj zhp msz
qdj: cjn qsz
gpd: gmv tgh mnh pqj lnm
qxt: ptj vlz fgz rkv
mcs: skv tvr bsk rxn
ffc: rxd xlb kvc shj dts
mkj: vht pzg vhd xjk
tvr: ksg ffz
lkl: jdt
jnt: szq
pkk: thk jdd nmf xgt
cvx: tld zqn
qtj: vrx sns zxm mxr
lcz: stz
xkj: bnx gdj sjl kkd
scd: crl ggx ctl
png: xjf bsk dgx hsf
srv: fgx xpp rhb
scz: hpn
bmd: bnh jxg
mpc: ccc bzz nhk
grx: kkd mss jph
lxk: rfb mfh cvc hvl phg stz
nvr: szd qdr cbv
zqn: qft
fnd: hjd gsd tld
mjb: pbp xzd
hls: bkb mrq nsn
zhk: pkn qpm rfm pjt
pjb: xsj vlb rsk
jgl: ddg
fcs: fvt
mdc: pkr zhp
vfv: nls dsh hhc nvb
ghk: tcx
mxx: hrh xkv sdr bnt
bqm: tvb
jkr: fmk
tdx: xjf zbl
clc: ktz lnv xqt
hql: xjt
dch: hhz sqd
gdx: rjr dhd
cbv: fdz
pmx: qsk srl
nmf: vfc lnv
gls: jlx lvp pgv ldq fmj qzf
nrj: mnc zhn tpq
dsb: xgs gjh znq
bvf: vgt
pgp: rsk
dbb: ptj flj
bcv: tln
mvf: vgv brv
gsz: ghf
lzb: mzg zpx
qnh: ddq
sjl: dhb vdj
vbn: zqv rmx rpq hps tqq
lvj: ldr xdt xkd lzb
sxc: bvf ffl vcb vrn kxz
kxs: bzz hqr
drj: jhx xkd bdr
krz: xkb tbh vmq ghn gdm
bkn: xpg hcf mzr rnc
ffj: pjk pqv tpq
skx: nfz vgf fhk
jrg: zth xkb
qlv: jlv prp tqv
cgq: srl
trb: nzk mdc nsm clx
qzr: vxq dph zdf tjv
pjs: ggm lkf ghl jch ggt
shs: gvl
dnz: srx ghf cpj knh
bmr: mzh bmg nxq
nfj: mvd
mqd: fxr bmg zqh
dfr: rnq zpq hvg blm
nrk: pll
jdm: kvn srx lgt tpr
spb: xlq bmd
vqq: rzz jvh nmq pds
sbm: mnb zpv
vqm: lxq skk nfq
vnm: tml llc rgj
tmr: ktz mkc ztk bcv
fhs: ttq qdr nmf
hpz: sps fdz
cvt: gvz tks jln
vbx: rdd sdj qkv
kdj: mnn jtj cvk
rlf: jxz spm
lgb: bfz tcd dkv
plr: lbv xzd
dbc: pps jrr ckr szl
cbl: ncv
cgr: mxc hcj skf xzv
fzf: mvz flc
qjd: pzb llc pgj vlb
hpl: vrv dmh skk nbc
lqs: lfz jvk gjt tfq bfr
gbj: dhq ztt xpg nqp jpq zzk lvz
jrk: qls xkv txs lzt
jkp: fzv kcx fhg lkl mqq
mmv: gfb nff nhs bxg
kpf: zdr ksg mkm ntx
cpb: spz
cps: plx pzb zps
rgp: pmk lrb rpn jgn
tkd: hbc jlx fzg xhg
xtb: gdg hjn rsr
hjt: rgh scd pds
qkf: hfr kfk kxb zgb
bmh: jpq cgc ktz ngp
tgn: nzd hdn rgj
hhk: xrc src szt
xnx: dhb jsx hqd htx
nhk: dhb
fqk: ztt csq kmf
bbb: tld qfs rpf
vzn: pff qzk dhq dzk
cxt: mfn hsf tpn rpn
zkx: bhg pbv pcz pmm
pvx: hfk kmd lfl hrh rmr
grc: cgx pgt jcb cfj
mkm: hcz sgx bxp
qkg: sjq lpl jjm gfj
ddp: vhj xtb nbc mbs
plh: dpn
cdv: pcz
ffz: dsh
hcb: ffl rkd fhs krf
qnm: lnf blz ckr
hkl: smk pbv rkd ngc
ksg: src
hhl: kxs
kmf: rfc dxd
vhj: bfz qdd bzr
sns: gnc tzh bkb
hbs: xjf zdr xxp
kgc: zrp cdp djb pcp
drk: mcb
hdn: gmv fft
xgb: jln gqd
lvz: cvx bnb
xdp: skx sdj rxb
xlq: rrk zdr cpj
trt: btn pfn srl cnl
czx: ctm xkd vqs
gbs: zxr sdr rbf
fzr: pbp pcp
ttd: mgt
tbt: nzm qkv jdd
qfz: rsl jgl dqv jbk
knh: lbj
bjh: xvg jxh jsp gfq xkt
zjr: lnk ksl zpx
lnx: xch vlj
znq: pdz lng
sbz: rxn
qmz: pzt
bmg: mmm
lql: zvp zsd zmk jbk
llg: fqz ffr
rsl: hpn hnn
qpl: gvc rfv
zjh: pbd cgx psq hqd vpz
dpn: lcv
xcq: pfb xmq flj
dfs: ftd brv ghk
fhx: hcj mzg jsp
qqt: mkc ptq xxp dtr xjt ndn
mxs: ktb gnv rqm nkz
vhk: qpg dph sbg hzc
fcm: prj hsb hql xvk
rpk: vlr jpq bnh
pps: mgp rll drx
cfj: tgn ngl
qqr: drg pbq
nsl: ftf zng jtr
sdr: fvt
hpj: shq jhg
ndx: mss hmm vjb hcj
cvz: lzm cpl mdc
slm: qqr drx mql lgz nbr
gzn: xzd dss mjb nqh
pnk: vfn ptt xzg
bch: sbm bjk nvx
svp: nsm xlj xkd
ppc: qnd kpr npt kxz
gfq: rxk ktb fjd
rjj: djb gjh lvl txv
prd: plh tcl
slc: kdj vgf crl phg
knn: gsf
sps: hcf mvd
gtx: psj ncv rhm lzm dlp
pls: shq mqq gdj xmm
vlz: bcp
xml: qhx tfp vdq cbz
fqz: xmq stl
lng: xxp
bhc: vks sbg
hqn: jbs rhn skk
jls: fzt zrt gxk ttq
xvl: pqm jsp tnb
mfk: phn xms
vmr: fml sch ttd xrh lpk
lgq: hmm hnn zhn mms
rhq: ddg jbf tfq tcl
mxm: spz kbl fhx jhj hmm
gnv: sqt jbk
vlf: bmb dzk qmb
bkb: hcj hfl
slp: bvf bfz fsr xxk xjk
kvn: hkd
xln: xvc
bxs: mss
xgk: dmg xvk ptt jxz
kqk: tpm zxk mpj dxd
hkd: jgx pdz
cqn: rqh bkr zhv gsl
gdf: lpk tdp tln nbb
bsk: lxq
cxr: bhg tgc ggx dqg
snc: msz qlk xvg
hvc: qsz
tjv: stz hvr
tnb: pbq
nrp: znq spb
frr: zgj scz nkr tbh
kzl: hql fll
cjn: xms hbt
tkl: tzd xjs pfb jcb
ffr: jrg
xgs: ctl
tzh: ldg
xkl: xnz mhk cxh
lnf: vhh kxc dzr
flc: clz scf
phz: hxm cxb mqd kcv krg
nzz: plq
pxn: xgn
hfk: hkd scd ngp
vht: vnc vlr
jvk: hpj zng cxh
rtx: jbf ljb drk lnn tcl
jgx: vvl cft blj
pmf: dzp ddq ngl fzf
mph: lbv sfn ckx
dkv: rcg qdd
gjh: sjf qcl
rpq: dqv zmn qnf cxm pvn
ksk: dkf hpz bzr tfp qzd
pgj: fxz
gpc: jng mrk qgr
drs: njx vlj tnb xzv
jgm: glq bvt
hqm: hhd rdc
chf: vts mzr sbz pds
shl: ddl prd
rnp: zvp
mps: fdp mvt nkb gvt
qpg: jrq
qsq: skx cvt jxq
snf: crf hzk
zbd: skv
stm: jkz ldg lcs
pzq: sxf mpr zps njx
bkq: tnf cpj
vhh: lgp
nmq: qcl tmj
scs: ggt nhr
crk: rsp kss rqm sfq
zpd: cjr bsp tkb qsz
zdh: xlq nch
fll: ghh xds
kbd: jqr vgv bqq mgb mql
dqg: rfv nft mvd mlh dmg
sxh: nnb lvn xds vqm
qrc: bzp knn nsn mpv
jzm: ljz zpd trh zmk
kmx: kkm blj
xjr: ltv
sqd: zvp jrg
bxp: kmf hrh htk
mms: qhd jgz nsd shl
dmt: sdn hbc qsz
qcz: shq ftd flc mvz
lfs: dzt
zsm: dkk cqz fvb qmf
zcv: ctl zbd ktk
nkb: mdb
dph: cbz lkj dmv fzt
hrh: tpr
zlv: lbv brb ktk
rjl: fvt kvh llv
kbl: snb rqz
fln: rpx fvn nqt csm
hzk: nqf
cmk: cbl nxv xbm mrq mrp cll qlx
shv: kcx
nrr: kmx
gzc: mqv rsb cjn
glz: qcz snf
rhz: stl xmq sqt
bsp: sqt
dzk: lbj gkx
cvj: jhg dhb mkz rqz lzm
qls: fvt cbz shf
jdg: ksd qft sjv ckq zdf
jzf: lbj tdx rvn lrd qmf qfs zjk
cgm: vdq fhk llv
kjg: ctl cpj nfj
msd: vnr blj rcg gfg
hfx: qjv gdn gmx zqh lrb rjr hvz
jhx: jjm mzg
gbg: flc knn
fsr: fgn kzp
vfn: dng
nbr: cpx
knd: rpx hbc fft
qmf: txv
tdr: tgc cvc
ksl: nrk hzk
lvm: mmh
bnz: sbm rll pxv kkk
ftx: lpl hhd
vbq: sdn tml
tpx: ghl jdt trh
rmx: tqt
blm: gdg ttd
tdv: pqj fhg gbg tml
qsm: ltt nrk
gjt: znn
gxk: pjt cgc
xbk: fjd hgx nkj fhg
bps: vdj
tql: jlz qhd lpj
lkj: rxn
zml: sss sdr ksg fcm trj
fzg: drx ljb
qgf: zqv mqq ktj qcg
fhc: ngg qhf mdb bjt bvt tkr ltv
qbs: shj spm vdq
shj: hsb
gcz: hsb
rpx: clg lcs
txz: xkv dxd
rdt: fhg gmv bxg
dlp: ztj
khg: rhn mvt
djl: clg
jxn: jvh rpr nbn lfs rbs
ggt: vlj
xzv: xvs cpc
gcl: zgb mrp rgq
bcz: rmx shx nzd rnp stm czf
mmm: bvm ktk
tkb: psq zmp
pbh: fvp lms cxk fvt lgb
prf: hqm sjd njc
fzv: tbh
xrs: vhm txs pzt bbr fvp
djj: vxr
jch: zth cpx
ppz: kss nhs nhr nfd
svh: rqz xch tbh zbz nsl xkj
qvb: dtn hql fvb dmh
psq: srl pgp
kks: skx ggx hzf
btp: zbx lxp
qzk: gvz gsd
dpj: kpr gsz
drx: nzz
jlx: zdp
klc: rvh rrv smx pcx
rhm: tml
mmg: dbb dpn ptj gnh
kqq: ltl plv xjk
sjx: xxk nfz rcz fsr
fgz: csn nps
gvc: qmb
ntx: qsq sjf bzr
nbn: tdx jrq nrp
jbk: stl
lmp: hcf pjt dkk
kjp: vdq tpr lmx xjr tpm
jlv: gnv
dkf: zjg xxp
rdd: pdz
mxl: jts ppz vmk
rxx: tmj
fft: xmq
bhb: mrk ksh xqt mvr
zpv: snb nff
ctx: qqj ghk
zps: tnb
kzp: vhc
xpp: nps
ltm: xcd gxl dfh
rsp: lkf btn bzz
htv: pll
mlq: xzg tvr zbd cgm cvt
kxt: dxd tph lnl ffz
xxx: xlb bnh
qjc: zps tzf khq fhx tvf
skf: sjb pgj kxq
pvn: qkn dqv
kmr: shs lbc vht dnz
ngp: ffn rpn
hhp: tpm hkd ckq
csn: pjk
xjf: qhf ckx
vct: tkr xhm dpq sps
jrv: jlv sjd nhk jkr
kfp: ktb bjl
xzx: qcl sdj sft
rgq: htv lmn mgf
pbk: xvc jtn ljp cgq
mgh: zhs gdn lfj
rmr: rnq qmb
vxr: zbz bdr
zdp: cpc
vjb: pkr
gmx: qzd czz
hqd: kzx
csb: gdj rqd qsk qql
lnv: xtg
ntl: lmx mvd ssv plr
jqr: rdc jnk
rlk: zdh lpk glq hjt
csm: klk jqr knk
qdb: nkj
krg: cvc zbd
lsg: dtl crf sfd ppz
zzr: ktx rhm xpp mgp
fzt: pxn
cxk: bxm
crs: htl fvt vfc
ndp: flj sqd rqz sdn
jmp: lxp hbt htv ctk jkr
nkf: ptq fcn
cjr: jlv lzb dnl
trj: kcr
mqf: rxn hvr
ktk: xhm
mzg: xln smx bbm
vdh: kzx vqs jjm fsg
llj: bgt fvh pll kcs gzc
nhs: xlj jrr
gmg: djl mnh dch
bgj: mbp gmx
zzk: lgt bzr jrq cxj
mzh: xhm xjr
pds: rxn
lxq: kcr bzr xjt
xnz: jlg sjq djl
glq: hcd
kdf: sjb rcv ztj rvh nzc
ppf: clb gvc gbv vzn vrv
flx: rvv nlx ddl
lfj: mcr rfm
ksh: gvz dng
fpt: mhk lkf scf hhs gjt
nvp: lbv fdz
dgb: rsb kpd mnc xvl
nqj: kdj llr cxk shs
fvn: mvf djl
njx: ghk
ztt: mkj
ngg: sdj tpj
tpn: lrd zcn mpj
dsh: dhd
nxn: dpl scs gnv lnk
hdq: smh nqt dlp mpr
tzf: mfk mkz mpr
qhh: mjx
qgs: sjb rxk sqt
cgx: jnm hpj rhz fft
hzl: pxv bcd bhn rqr
fxn: dsg bjt lcz srx
xgt: jfc
bgk: sjd qsk
bpv: nch kmf lgt
sjn: jjd hfr qcg
clb: rlf dkh pzg
dmm: rjr lkj hzf
dxb: snb vvf clx
mbp: qbj
xsf: hft gcl xcq zhp
xhm: rrk
dgz: xgb fhs gvc rbf nqh
fml: qdd sgf
nfd: kpd ddq kxb
trz: prp pgp zgj fvn
dzp: stl
hvx: hvl llv
kpt: fzf pbk xrp
jqj: chf fxr tpm glh
vcb: sbz kzh ksd
jmg: vjb ggm mqv
vcc: crf sxq knd zmp
nkc: mjc rlf gqd
xjs: jjm kbl trz
sfd: jrr jjk
zbz: tpq
xlj: clz
lfz: mql scz rdc
knt: qnd nch rxb qpm
xvc: zth
hzt: vhh bcd
vjg: dfc tgh jnt
jfd: ctk prm kzx
vmq: rgq btn
gts: qxg qhh flj jkm
xdz: nzz blz xvs mnh
zzl: znb cph mph dsb xrh
msz: lkf nps fsl
rml: jdg vjt sfp
gkq: rfv skm
kgl: plh fzf kxb
jhj: vnx
xrh: jjz
tns: gtt rrk lnl ptq
qrr: dnb mxx vpn crp
dpl: qqr rhb
zxk: rtv ssv
qlz: rvv vfb csg ghn mcb jgz lsj vtf
vvf: pxv zdp
ghj: qnh trz hqr
tfj: xpg ghh
xvs: prd pxv
ptl: plq
kph: jsp hjc hhz kzx
mhk: phn
rfb: dtr kpr
vxq: vpf gqd zbd bqm dkf
ckk: skv
skh: sxf mrp nqf dlq
plf: rsk gmv fvn pgj
pqm: vnz fxz
lcd: vdm njx ddl nzz
hvg: ktz
gxl: nhr
vjj: bmg tbt
tqt: bgg
pjk: lnm
ddj: spr dns nnb tdr lkh
hjn: bzl hzc ctl
rqd: mvz pzb hhl
hjc: ztj
sjg: jxg xds
bbm: mlh
ssz: sbg rdd vcp rcz
ttm: xsf hfr stm hls
hjd: blm dmg
bfz: khg
jxq: xgs
bgt: mcb zhn ctd
dbz: rrk fhc qnj txz
vtf: tml jnt rhm
vfb: vsn bfx pjb fdr
zrp: dss
tjj: jdg dkk sbs lvn
qft: ttd dpq
zsd: hnn smx
lxn: qhf fhk mdb
jsr: shv gsf zsd bdr
nkz: jlz xpp phn
bcd: mqv
rnf: dmt ngl
gqz: mcm qnh jnm qrc
lsj: mxl cvz kpt
qnp: jlz jjk mjx
zvf: hcd nxq hhc
qnj: dgx jgm
vpn: vgt hbs shs vbx
bnt: nxq
hhz: kss
lhz: bmr tfj kkm
vjk: dfh pjk phn zhp
skl: kzl gbj zll nbb
ncb: cxk rdd bkq gkq
kvh: jtj rtv dpj tnh
rcf: qnm ctm nfv pmx gxl ldq
tpj: dnb
bjl: zmk
dlq: hpn vnx ctm
pxb: srx
rnt: mgb tzd qxj
mqv: glx
bfr: ljp tqv dvg rsk xkm
nft: tnf ksg vvs
dkh: ptq hvx hhk bpv txs
kvc: jqs kks zxr
mvt: gsd rfc
qnd: dsh rpn xrc
fvb: jqs crp mzr
ntg: gbk jkp vnx dkq nsd
lrb: vtt
zll: dxd szd vjj
htz: dmm fjr zxx nbb mrk
ttq: zxd qzk
ndn: rkd mgl lvn kzp
vfg: spz sxf ztq vhl
gqp: dns kvn zhs sch
bbr: lbj gcz
rcv: dbb cbl mdg vbq mcm
tsv: sgx jdd lvl
fsl: xsj mgp ngd
lcn: qbj rbs
mxr: lpl qpt hzk
smh: pcx gzt
hvb: fbl
hfl: tnk zhp
sfp: vfn
blz: lzr fhg bvx ltt sqd
qql: ztj nhb nsd
xvg: nhb
qhg: xkd
gmv: jhx
dns: zhs pzg bvt
gtf: bvm lcn dmg lvl
bxm: bgj kxz gfg rlb vfv
mdk: zdr tmr csq
bbk: bvm vjj
kkm: tks
qfs: fml
kbq: sjl bjk pjb jcb dpl ccb
rkj: szl ngd cgq
hnn: sdn
fgh: vlf nkc trj znb
ltt: hhd
qxg: pqv rll vlz
pvg: zmn gcf prp
ngc: vnc fhk sfr
qjv: zdf
szb: dgx hvx vcb
nsm: clg
ddm: fxf zjg svn llr
rnr: vtt tpk bvm bmb
zfr: ccb hxb gbk svp jhj qkn
nsn: gsf
mqq: lsd
jrq: tmj
szd: ggx bcv
rsb: qdb vbq
vrx: dnl
zfh: qxj zzb vnz rtz
kmd: qkv vhc sdj
ngv: sgf hvr lmx llr
rbb: jxz jbs rxd shf
xzg: ltl
hsn: nqt szl glx tcl
jzb: ghf hck nvr czz mjb sjg
zqh: mgl vnr
dlg: vfn rfm rfb qnj
pbd: hfr rsp bkb
xkb: stv mqv
bxn: nrr qrt tjv bvf
lmx: lvm
vhd: bmd
pnm: plx sbp rnf llc
lxj: zbd llv rxb
lzt: mkc dtr
xpg: lms drm
qpt: rnt kfk mjx
pcx: nrj nlx
kcz: sch kdc gtt rnc mgh
ctk: djl
rkd: qbj
nfz: hcd zcn
vpz: tzd
tzd: rrv
jmf: mbs dtd hjt xqt
fvp: brb
tsj: kfp zjr trh ptm
szq: jrg xkd
lgp: spz
zhv: vzn cxt frt
brb: dhd lvn
rxd: qjv dsg fhc
vhf: xgs tcd sbg rxx djb
dvg: bvx ptl vhl spl
fjc: nkj qsm plq lgp
cxm: mrp
tph: mjc nrr lmp zxd
glh: ppl bhc
hps: jkz lrt qdb
kxz: qzd src cdp
ffn: hjd
sjq: ptm sxf nsd xmq
kgd: xmm tnk scz vlj
gfj: kkd ltz glx ptl
vsn: cxh jgl rnp
nsx: lmn mzg dfh
mmh: gdg qmz
lct: vnm qrc jtr rcv
vts: ckx qft tfp
qzx: vtt bnh djb rjr
hdv: llg llc dfh qnf jdt njc kcs
zcn: plv
pgt: zqj
klb: gjt pkr mfj bps
sss: vjt xdp zcn
ttf: lgt rgp hhc
crv: vvf ldr jjk sqt
nzc: nkz
dtl: hhl fxz kgl
lzr: hhz zng
nbg: nps qlx fdm
vlb: tqv hbt
htx: rmx zmn xkm
fch: jcc tcx ddl hdv
xkt: ghk
szt: cft fbl
krf: kcv trv
rrv: xdt
cxh: dbg fsg
jmt: rvh jnm kss hft
sbg: hvb
mvr: fzt ffh kvh xlb
tbn: hzt dxb clz zbq
tmz: ltv nhl bqm rfv
cdp: jpq
xvk: stz rhn jbs mvk
mgf: rxf sxq
gvt: jxg txs dmv
jlj: jmp nqf tpx zqt kcs tvf
xfz: qjv ffz pkn qdr
bnf: bgj jbh znb
cft: mcr
zxq: rlb svn vxq sfp rmr
nxv: zhn mtl dbg
vxl: fhx zbx msl bjl
rns: sjv sch ckx
clx: cjn jrr kzx
rvh: pgp
hck: dng nvt
lgh: tpm bnt
vzr: dbh snc qqj dch cxm hnf
lvp: ztz sxf ljz
hhs: tcl zqj lnm
jts: zjr pqm cnl ptm
jkm: rxf qsz
lmn: gsf fmk
rch: prf fxz qhh vkr
gfb: mql jrv gfz
jlg: nkj ctd
mlp: zng jkz kcx
pfn: zqt ztj rsl
zxm: vpc ddq zpx rxk
txv: hvg drh
hmk: gqd nrp spb jpq
zjg: nvt
vrt: lcz gvz
cqz: kzh mkc
vdm: llq qcz jhg
rgh: mrk blm
ghh: dkk hvb
crq: qfs nfq mxx znb
dmx: qmz lgh sps gkq
svt: grx
nkk: fhp vvl
gfh: xzg glh rjl dzt
qmv: xtg hvg rnc bmb dtn xxx
fsj: mxp nmm zqp cdp
ltz: jsp plh gcf
dqv: rnf
zqv: nrk
zcc: dnb sft bnh
phg: dhd lrb
fgn: rhn rsf nhl tvb hzf nfq
lqz: xtg vks bbb
scj: xkt hqr plf nsm
lzk: lsd nzc
nmm: vrv snn
zbl: cdv mcr
knk: ghn nzc
dbh: lsd xmq
btn: sdn
jnm: lrt
kbs: pth vpc jqr hdn bch
qxj: cnl
sft: tnh
qmc: rbs sjf gcz mbp trv
lgz: fgz sxf xdz
tgc: dgx
ssb: jfc qkz nkf bfj gdx pkn
bkr: mrb znb
mgl: lnv vks
trv: svn smk
jxh: nhb nkj jcc
hsf: nhl mmh lfs
bzn: jgz qdj pzq
rlb: zdr
bjk: ggt cnb
zxt: bgk bcp mpc
ppl: rvn nvt
tcd: nnb
tpk: bmg xgn ksh htl
zfn: kgc qzx crs cph
npt: rkq gcz
rtz: shv
cdt: gbs rgh bbb
gqb: vjq fjr hxm
nlx: rdc kcx lxp
jbh: npt cdv
shx: xlc hqm ncv
xkm: ljb prc
tkp: hqh lnk xkt ngd
crl: lrd gsd
ksd: xjk
gfz: szx xms kxc
lrt: ltt
gbv: mgt lbv vtt fcn
fmk: bqr
nch: htl
qhf: fjr
vch: tpq fsg stv xln
snb: fsg
mfn: ghf cbv
mdb: tvb mpj
hjz: bqm gxt xxp vlr
zrt: gkx sfn kfr
ptt: tks
mvk: htl nbb
zlr: bfj htl cph hvl
dbg: gsf
mdg: tzh ztq
jtn: rkj
xsz: blm pxb krg jqs
vvl: zxx
hpn: ljp tcx
szz: ltl pxn cft bcv
gzx: vgv tqq mgb ljz
bxg: ztz
qrt: hsb shs
hhf: ptt zqn vgf
rcg: sdj
pqp: sjq kxq rqm gbk
htl: jfc
jxz: dmv rkq nvt
csg: mfk shx vrx
kfk: cpc
bbf: jjz ptp dnb gtf
kpm: kzh ptt vgf smm fxn
qcg: jjk
sln: xxk xjt knt zxk
fds: hhk fnd hvz cph
ltl: sgf
gsf: kpd
ljm: tln qnj rbs rfb
ngm: cpb scs tgh bnr nkr
vnp: vpz tfq ktx jfd bvx
ddq: prc
gvx: fmk hqd lrt rqz
pcj: mnc xln hhd dkq
nqt: tqt
gnc: hhz xtp vch zth
xqt: rdd hqx
mnb: hqh bxs cxm
rfc: mjc dtr
kdl: tld zxd bnm kxz
htj: zqv pbk qxj lzk psj
npb: drk lxp lkl pqj
nqh: nkk pkn
bnb: mcr
dpd: dpj lng kzh gsz
tnf: pdz ksd rpf
ldg: rrv dnl
msl: sdn stv brv vrx
kvq: gmg shv cpc skh xvg
bpk: vlf bhg gkx csq
xrp: cll lcv cts
tmd: mfh nmm bbk hvr
lkh: kvc npt zgk
gfx: zrp zhs qmz rfc
kcl: mhk gdm rtz bzt pzv
gdn: rtv
flm: klt tkr vhd plv
dfz: hvx nkb lbj lxj
vhm: czz
pth: pgp csn rkv flc
fgx: msl xsj pqj
dhh: lvk svt qlp zxt
dfc: cbl ngd gsf
jjd: tgh mxc cpb
dzr: rkj grx pmx
vbl: dzp zvp cts vcc nps
cjq: zpv mxc srv zqj
vpf: fxr dpq
gcf: fmj xdt
gxt: tph nvb bnh